10
0; 3//
0 7 0; 4//
0 6 7 0; 0//
0 7 6 0; 0//
3 6 7 3; 1//
3 7 6 3; 1//
4 6 7 2; 2//
4 7 6 2; 2//
2 6 7 4; 2//
2 7 6 4; 2//
25 121
0 1 1 1 1 1 1 1 1 1 0 121 121
1 1 1 1 1 1 1 1 1 1 0 121 121
2 1 1 1 1 1 1 1 1 1 0 121 121
3 1 1 1 1 1 1 1 1 1 0 121 121
4 1 1 1 1 1 1 1 1 1 0 121 121
5 1 1 1 1 1 1 1 1 1 0 121 121
6 1 1 1 1 1 1 1 1 1 0 121 121
7 1 1 1 1 1 1 1 1 1 0 121 121
8 1 1 1 1 1 1 1 1 1 0 121 121
9 1 1 1 1 1 1 1 1 3 0 29 29 29 92 111 92 121 29
10 1 1 1 1 1 1 1 1 3 0 57 57 57 64 103 64 121 57
11 1 1 1 1 1 1 1 1 1 0 121 72
12 1 1 1 1 1 1 1 1 1 0 121 84
13 1 1 1 1 1 1 1 1 3 0 18 92 18 103 85 103 121 92
14 1 1 1 1 1 1 1 1 3 0 20 99 20 101 81 101 121 99
15 1 1 1 1 1 1 1 1 3 0 22 105 22 99 77 99 121 105
16 1 1 1 1 1 1 1 1 5 0 10 109 10 24 101 24 97 73 97 111 101 111 121 109
17 1 1 1 1 1 1 1 1 5 0 12 113 12 25 97 25 96 71 96 109 97 109 121 113
18 1 1 1 1 1 1 1 1 5 0 15 117 15 22 91 22 99 77 99 106 91 106 121 117
19 1 1 1 1 1 1 1 1 3 0 17 120 17 104 87 104 121 120
20 1 1 1 1 1 1 1 1 3 0 19 121 19 102 83 102 121 121
21 1 1 1 1 1 1 1 1 3 0 21 121 21 100 79 100 121 121
22 1 1 1 1 1 1 1 1 5 0 5 119 5 23 111 23 98 75 98 116 111 116 121 119
23 1 1 1 1 1 1 1 1 5 0 13 115 13 24 95 24 97 73 97 108 95 108 121 115
24 1 1 1 1 1 1 1 1 5 0 19 111 19 26 83 26 95 69 95 102 83 102 121 111
